00000000000
00a00000c00
0..a......0
00.00.00.00
00000000000
0<...c...<0
00.00.00.00
00.00.00.00
0.a..<..a.0
00000000000
00000000000
